|-----------------------------------------------------------------------------|
|                |----------|                                          |--|   |
|              |-|..........|                                        |-|..|   |
|              |............|                                      |-|...|    |
|             |.............|                                    |-|.....|    |
|            |..............|                                  |-|......|     |
|         |-|..............+#################################+-|.......|      |
|         |................|     #                         |-|.......|-|      |
|        |.................|     #                       |-|.......|-|        |
|       |..................|     #                       |.....|---|          |
|       |------------------|   |-+---------------|       |-----|              |
|                              |.................|                            |
|                              |..................|                           |
|                             |...................|                           |
|                             |...................|                           |
|                             |-|.................|                           |
|        |--------|             |+----------------|                           |
|     |--|........|-----|        #                        |--------------|    |
|     |.................|--|     #                        |..............|    |
|     |....................|-|   #                       |................|   |
|      |.....................|   #                       |.................|  |
|      |......................+#########################+...................| |
|      |----------------------|                         |----|...............||
|                                                            |---------------||
|-----------------------------------------------------------------------------|
