|-----------------------------------------------------------------------------|
|          |--------|                                                         |
|   |------|........|--|                                     |-----------|    |
|   |..................|-|                         |---------|...........|-|  |
|  |.....................|-|                       |.......................|-||
|  |. |....................|                        |........................||
| |.| |.....................|                       |-|......................||
| |.||.......................+#########################+...................|-||
||............................|     #                  |-|........|-------+|  |
||.............................|    #                    |--------|       #   |
||---------------------------+-|    #   |--------|                        #   |
|                            #  |---+---|........|                        #   |
|                            ###+..............|-+#########################   |
|                            #  |...........|--|                          #   |
|                            #   |........|-|                             #   |
|                            #   |.....|--|                               #   |
||---------------------------+-| |--+--|                |-----------------+--||
||.............................|    #                   |....................||
||.............................|    #                  |....................| |
||.........................-..|     #                 |....................|  |
| |...........................|     #                |.....................|  |
| |-|........................+######################+.....................|   |
|   |----|...................|                     |.....................|    |
|        |-------------------|                     |---------------------|    |
|-----------------------------------------------------------------------------|
