|-----------------------------------------------------------------------------|
|          |--------|                                                         |
|   |------|........|--|                                     |-----------|    |
|   |..................|-|                         |---------|...........|-|  |
|  |.....................|-|                       |.......................|-||
|  |. |....................|                        |........................||
| |.| |.....................|                       |-|......................||
| |.||.......................|                         |...................|-||
||............................|                        |-|........|--------|  |
||.............................|                         |--------|           |
||-----------------------------|        |--------|                            |
|                               |-------|........|                            |
|                               |..............|-|                            |
|                               |...........|--|                              |
|                                |........|-|                                 |
|                                |.....|--|                                   |
||-----------------------------| |-----|                |--------------------||
||.............................|                        |....................||
||.............................|                       |....................| |
||.........................-..|                       |....................|  |
| |...........................|                      |.....................|  |
| |-|........................|                      |.....................|   |
|   |----|...................|                     |.....................|    |
|        |-------------------|                     |---------------------|    |
|-----------------------------------------------------------------------------|
